03 00 00 03 03 03 03 03 03 03 03 03 03 03 03 03 03 03 03 03 03 03 03 03 00 00 00 00 00 00 00 00 03
03 00 00 00 00 00 03 03 03 03 03 03 03 03 03 03 03 03 03 03 03 03 03 00 00 00 00 00 00 00 00 00 03
03 00 00 00 00 00 03 03 03 03 03 03 03 03 03 03 03 03 03 03 03 03 03 00 00 00 00 00 00 00 00 00 03
03 00 00 00 00 03 03 03 03 03 00 00 00 00 00 00 00 00 00 03 03 03 03 03 00 00 00 00 00 00 00 00 03
03 00 00 00 00 04 04 04 04 04 00 00 00 00 00 00 00 00 00 04 04 04 04 04 00 00 00 00 00 00 00 00 03
03 00 00 00 00 01 06 01 01 01 00 00 00 07 08 09 00 00 00 01 01 01 06 01 00 00 00 00 00 00 00 00 03
03 00 00 00 00 00 00 00 00 00 00 00 00 10 00 11 00 00 00 00 00 00 00 00 00 00 00 00 00 00 00 00 03
03 00 00 00 00 00 00 00 00 00 00 00 00 12 13 14 00 00 00 00 00 00 00 00 00 00 00 00 00 00 00 00 03
03 00 00 00 00 00 00 00 00 00 00 00 00 00 00 00 00 00 00 00 00 00 00 00 00 00 00 00 00 00 00 00 03
03 00 00 00 00 03 03 03 03 03 03 03 03 03 03 03 03 03 03 03 03 03 03 03 00 00 00 00 00 00 00 00 03
03 00 00 00 00 03 03 03 03 03 03 03 03 03 03 03 03 03 03 03 03 03 03 03 00 00 00 00 00 00 00 00 03
03 00 00 00 00 03 03 03 03 03 03 03 03 03 03 03 03 03 03 03 03 03 03 03 00 00 00 00 00 00 00 00 03
03 00 00 00 00 03 03 03 03 03 03 03 03 03 03 03 03 03 03 03 03 03 03 03 00 00 00 00 00 00 00 00 03
03 00 00 00 00 03 03 03 03 03 03 03 03 03 03 03 03 03 03 03 03 03 03 03 00 00 00 00 00 00 00 00 03
03 00 00 00 00 03 03 03 03 03 03 03 03 03 03 03 03 03 03 03 03 03 03 03 00 00 00 00 00 00 00 00 03
03 00 00 00 00 00 02 02 02 02 02 02 02 02 02 02 02 02 02 02 02 02 02 02 02 02 02 00 00 00 00 00 03
03 00 00 00 00 00 02 02 02 02 02 02 02 02 02 02 02 02 02 02 02 02 02 02 02 02 02 00 00 00 00 00 03
03 00 00 00 00 03 03 03 03 03 03 03 03 03 03 03 03 03 03 03 03 03 03 03 00 00 00 00 00 00 00 00 03
03 00 00 00 00 03 03 03 03 03 03 03 03 03 03 03 03 03 03 03 03 03 03 03 00 00 00 00 00 00 00 00 03
03 00 00 00 00 03 03 03 03 03 03 03 03 03 03 03 03 03 03 03 03 03 03 03 00 00 00 00 00 00 00 00 03
03 00 00 00 00 03 03 03 03 03 03 03 03 03 03 03 03 03 03 03 03 03 03 03 00 00 00 00 00 00 00 00 03
03 00 00 00 00 04 04 04 04 04 04 04 04 04 04 04 04 04 04 04 04 04 04 04 00 00 00 00 00 00 00 00 03
03 00 00 00 00 01 01 01 06 01 01 06 01 01 01 01 06 01 01 01 01 01 01 01 00 00 00 00 00 00 00 00 03
03 00 00 00 00 00 00 00 00 00 00 00 00 00 00 00 00 00 00 00 00 00 00 00 00 00 00 00 00 00 00 00 03
03 00 00 00 00 00 00 00 00 00 00 00 00 07 08 09 00 00 00 00 00 00 00 00 00 00 00 00 00 00 00 00 03
03 00 00 00 00 00 00 00 00 00 00 00 00 10 00 11 00 00 00 00 00 00 00 00 00 00 00 00 00 00 00 00 03
03 00 00 00 00 03 03 03 03 03 00 00 00 12 13 14 00 00 00 03 03 03 03 03 00 00 00 00 00 00 00 00 03
03 00 00 00 00 00 03 03 03 03 00 00 00 00 00 00 00 00 00 03 03 03 03 00 00 00 00 00 00 00 00 00 03
03 00 00 00 00 00 03 03 03 03 03 03 03 03 03 03 03 03 03 03 03 03 03 00 00 00 00 00 00 00 00 00 03
03 00 00 00 00 00 03 03 03 03 03 03 03 03 03 03 03 03 03 03 03 03 03 00 00 00 00 00 00 00 00 00 03
03 00 00 00 00 03 03 03 03 03 03 03 03 03 03 03 03 03 03 03 03 03 03 03 00 00 00 00 00 00 00 00 03
03 00 00 00 03 03 03 03 03 03 03 03 03 03 03 03 03 03 03 03 03 03 03 03 00 00 00 00 00 00 00 00 03
03 03 03 03 03 03 03 03 03 03 03 03 03 03 03 03 03 03 03 03 03 03 03 03 03 03 03 03 03 03 03 03 03